000000000000000000000000000000
000000000000000000000000000000
000000000000000000000000000000
000000000000000000000000000000
000000000000000000000000000000
000000000000000000000000000000
000000000000000000000000000000
000111000200000000000000000000
000000001110000000000000000000
000002000000011100002000000000
000001110011100000011100011000
111111110011110001111100111111